5
5
#####
#R  #
# @ #
### #
###0#