6
6
######
#R  3#
# 3 @#
### ##
#5   #
###0##