6
6
######
#R   #
# @ @#
### ##
#    #
###0##